#########
#   $    #
#  *  *  #
#  *  *  #
#  *  *  #
#  *  *  #
#  *  *  #
#  *  *  #
#     . @#
#########