#######
#@#    #
# #$   #
#    ###
# # #  #
#      #
###### #
#.      #
# #     #
#####  #
     ##