##########
#        #
#   $    #
#  *  *  #
#  *  *  #
#  *  *  #
#  *  *  #
#  *  *  #
#  *  *  #
#     . @#
#########