   ####
####  ##
#.     #
#      #
#      ##
##      #
 ##     #
  # $ ###
  # @ #
  #####