  #####
##   .#
#   ####
#      ####
#         #
##     $  #
 ##   #  #
  #   ###
  # @ #
  #####