  #####
##    #
#     #
#      #
#      ##
##  .   #
 ## *   #
  # $ ###
  # @ #
  #####